111111111111111111111111111111111111111111111111
100011001000000010000111001000110010100110000111
102011011000000000010000001000110110000000110111
100000011000000010010111111011110100111111110111
111111111111111111111111111111111111111111111111
111111111111111111111111111111111111111111111111
111111111111111111111111111111111111111111111111
110000000000000000000000000000000000000000001111
110000000000000000000000000000000000000000001111
110000000000000000000000000000000000000000001111
110000000000000000000000000000000000000000001111
111111110000000000011111111000000000000011111111
111111110000000000011111111000000000000011111111
111111110000000000000000000000000000000011111111
111111110000000000000000000000000000000011111111
111111110000000000000000000000000000000011111111
111111110000000000000000000000000000000011111111
111111110000000000000000000000000000000011111111
111111110000000000000000000000000000000011111111
111111110000000000000000000000000000000011111111
111111110000000000000000000000000000000011111111
111111110000000000000000000000000000000011111111
111111110000000000000000000000000000000011111111
111111111111111111111111111111111111111111111111