111111111111111111111111111111111111111111111111
100011000000000010000111001000110010100110000101
102011011000000000010000001000110110000000110101
100000011000000010010110111011110100111011110101
101111111111011111111110111011110110111000010101
100000000001011111111110000000000000111000010001
111111011111011111111111111111111111111111011111
110000000000000000000000000000000111000000001101
110011111111011111111111111111110111000000001101
110010000001000000000000000000010111000000001101
110010000001011111111111111111010101000000001101
110011110001000000000000000001010001111111111001
110011110111000000000000000001000000000000000011
110011110001000000000000000001011111111111111011
110011111101000011111100000001000000000010001001
110011110001000010000100000001010000000010101101
110011110111000010000100000001010000000010100001
111001110001000010000100000001010000000010111111
101100111100000011101100000000011111111010000001
100110010000000000000000000000000000000011111101
100011000000111101110101111111111111111110000001
100001100000100000010101000000000000000010111111
100000000000100100010000001000010000100010000021
111111111111111111111111111111111111111111111111